XXXXXXXXXXXXXXXXXXXXXXXXXXXXXXXXXXXXXXXXXXXXXXXXXXXXXXXXXXXXXXXXXXXXXXX XXXXXXXXXXXXXXXXXXXXXXXXXXX
X   X               X             X                     X         X       X           X     X     X
X X X XXXXXXXXXXX X XXX XXX XXXXX X XXXXX XXXXXXX XXXXX XXXXXXXXX X X XXXXX XXX XXXXX XXX X X XXXXX
X X X     X X     X   X X X     X X X   X     X   X   X           X X     X   X X         X X     X
X X XXXXX X X XXXXXXX X X XXXXX X XXX X X XXX XXXXX X XXXXXXXXX XXX XXXXX XXX X XXXXXXXXXXX XXXXX X
X X     X X X   X     X     X   X   X X X   X       X X       X X     X   X X X         X         X
X X XXXXX X XXX XXX XXXXXXX X XXXXX X X XXXXXXX XXXXX X X XXXXX X XXXXX X X X XXXXXXXXX XXXXXXXXX X
X X     X   X X   X X     X X     X   X X     X   X   X X       X   X   X   X X   X   X X     X X X
XXXXX X XXX X XXX X X XXX X XXXXX XXXXX X XXX XXXXX XXX XXXXX XXXXX X XXX XXX X X X XXX X XXX X X X
X   X X     X X   X   X X X   X   X   X   X       X   X X   X X   X X   X X     X   X   X X X X   X
X X XXX XXXXX X XXXXXXX X XXXXX X X X XXXXXXXXXXX XXX XXX X XXX X X XXX XXX XXXXXXXXX XXX X X XXXXX
  X   X       X     X   X   X   X X X   X     X       X   X X   X X X X     X       X   X X X     X
XXXXX XXXXXXX XXXXX X XXXXX X XXXXX XXX X XXX XXXXXXX X XXX X XXX X X XXXXXXX XXXXX XXX X X XXXXX X
X   X   X   X     X X     X X       X   X X X     X   X   X X X X         X   X   X X   X X   X   X
X X XXX X X XXXXXXX XXXXX X XXXXX XXX X X X XXXXX XXXXXXX X X X XXXXXXXXXXX XXX X X X X X X X X X X
X X   X   X         X   X X     X X X X X X     X X       X X X     X   X   X   X   X X X X X X X X
XXXXX XXXXXXXXXXXXXXX X X XXXXX X X X XXX X XXX X X XXXXXXX X XXX X X X X XXX XXXXXXX X X X XXX X X
X   X   X         X   X     X   X   X   X X X   X   X   X   X     X X X   X X X       X X   X   X X
X X X X XXX XXX X X X XXXXX X XXXXXXXXX X X X XXXXXXX XXX XXXXXXXXX X XXXXX X XXXXX XXX XXX X XXX X
X X   X   X X   X X X   X X X X         X X X   X       X     X X   X   X   X X     X     X X X   X
X XXXXXXX XXX XXX XXXXX X X X X XXXXXXX X X XXX X XXXXX XXX X X X XXXXX X XXX X XXX XXXXXXX X X XXX
X   X   X   X   X       X   X X X       X X X X       X X   X   X   X   X     X   X X       X X X X
X X X X XXX XXX XXXXXXXXX XXX X XXX XXXXX X X XXXXXXXXX X XXXXXXXXX X XXXXX XXX X X X XXXXXXX X X X
X X   X   X   X X       X   X X   X     X X     X       X           X     X X X X X X       X X   X
XXXXXXXXX XXX X XXX X XXXXX X XXX XXXXX X X XXXXX XXXXX XXXXXXXXXXXXXXXXX X X X X XXXXXXX XXX XXX X
X         X X X   X X X     X   X X X   X X X     X   X X     X     X     X X X X X     X X   X X X
X XXXXXXXXX X XXX X X X XXXXXXX X X X XXX XXX XXXXX XXX X XXX XXXXX X XXXXX X X X X XXX X X XXX X X
X     X     X     X X X     X X X X     X   X     X   X   X X       X X     X   X   X   X X   X   X
X XXX X XXX XXXXXXXXX XXXXX X X X XXXXXXXXX X XXX X X XXXXX XXXXXXX X XXX XXXXXXXXX X X X XXX XXX X
X X   X X     X         X   X X X           X X   X X       X     X X   X X       X X X X   X   X X
X X XXX X XXX X X X XXXXX XXX X XXX XXXXXXX XXX XXX XXXXXXX X XXX X XXX X X XXXXX XXX XXXXX XXX X X
X X X X X   X X X X X   X   X X   X   X   X     X   X X   X     X     X X   X   X   X   X   X   X X
X X X X XXX XXX X XXX X XXX X XXX XXXXX X XXXXXXXXX X X X X XXXXXXX XXX XXXXX X XXX XXX X XXX XXX X
X X X X X X     X     X     X   X     X X         X   X X X   X   X X   X X   X   X   X   X   X X X
XXX X X X XXXXXXXXXXXXXXXXXXX X XXXXX X XXXXXXXXX XXX X X XXXXX X XXX XXX X XXX X XXX X XXX XXX X X
X   X   X       X             X     X X   X     X   X X X X     X X   X       X X X X X   X   X X X
X XXXXX X XXX XXX XXXXXXX XXX XXXXXXX XXX X XXX XXX XXX X X XXXXX X XXXXXXXXX X X X X XXX XXX X X X
X     X X   X X   X X     X X X     X     X   X   X X   X   X       X   X   X X X   X X   X   X X X
X XXX X XXX X X XXX X XXXXX X X XXX XXXXXXX X XXX X X XXXXXXX XXXXXXX X X X X X XXX X XXXXX XXX X X
X   X X X   X       X   X   X X   X       X X X   X X     X       X   X X X X X X   X     X   X X X
XXX X X XXXXXXXXXXXXXXX X X X XXX X XXXXX XXX X XXX X XXX X XXXXXXX XXX X X XXX X XXXXXXX XXX X X X
X   X X       X       X X X   X X X     X     X X   X X   X X     X   X X X     X X     X   X X   X
X XXX XXXXXXX X XXXXX X XXX XXX X XXXXX XXXXX XXX XXX X XXXXX XXX XXX X X XXXXXXX X X XXXXX X XXX X
X   X     X     X   X X   X X   X   X X   X X X   X   X       X X X   X X X       X X   X   X   X X
XXX XXXXX XXXXXXX X X XXX X XXX XXX X XXX X X X XXX XXXXXXXXXXX X X XXX X XXXXX XXX XXX X XXXXX X X
X X     X       X X X     X       X X X   X X X   X X           X     X X     X X   X X   X     X X
X XXXXX XXXXXXX X X XXXXXXX XXXXX X X X XXX X XXX X X X XXXXXXXXXXXXXXX XXXXX X X XXX XXXXX XXXXX X
X     X     X   X X   X   X X   X X   X X   X   X X   X X         X     X     X X X         X   X X
X XXX XXXXX X XXX XXX X X XXX X XXXXX X X XXXXX X XXXXX X XXXXXXX X XXXXX XXXXXXX X XXXXXXX X XXX X
X X     X           X   X   X X     X X X               X X     X   X   X                   X X   X
X X XXX X           XXXXXXX X XXX XXX X XXXXX          XX X X X XXXXX X X XXXXX           XXX X XXX
X X X   X           X X     X   X   X X     X             X X X   X   X X X X               X X   X
X X XXXXX           X X XXX XXX XXX X XXXXX X          XXXXXX XXXXX X XXX X X X           X X XXX X
X X   X               X X X   X   X   X   X X           X     X   X X     X X X           X     X X
X XXX X XX          XXX X XXX XXX XXXXX XXX X          XX X XXX X X XXXXXXX X XX          XXXXXXX X
X X   X             X   X   X   X X   X X   X             X X   X   X X     X             X   X   X
X X XXXXX           X XXX X X XXX X X X X XXX          XXXX X XXXXXXX X X X XXX           X X X XXX
X X     X           X X   X   X   X X X X   X               X       X   X X   X           X X   X X
X XXX X XX          X X XXXXXXX XXX X X XXX X          XXXX XXXXXXX XXXXX X XXX           X XXXXX X
X   X X   X X   X     X X     X     X X   X X X     X X     X     X   X   X X   X   X X X X X     X
XXXXX XXXXX XXX XXXXXXXXX XXX XXXXXXX XXX X X XXXXXXX X XXXXX XXX XXX X XXXXX XXXXXXX X XXX XXX XXX
X     X     X X     X     X   X     X     X X     X     X X   X X     X     X         X   X   X   X
X XXX X XXXXX XXXXX X XXXXX X X XXXXXXXXX X XXX XXX XXXXX X XXX XXXXXXXXXXX XXXXXXXXXXXXX XXX X X X
X X X X X       X X   X   X X   X     X   X   X   X   X   X     X         X         X       X X X X
X X X X XXX XXX X XXXXX X X XXXXX XXX X XXXXX X X XXX XXX XXXXX XXXXX XXX XXX X XXXXX XXXXX X XXX X
X X   X   X X   X       X X X   X X X       X X X   X X       X       X X   X X X   X X     X   X X
X XXXXXXX X X XXX XXX XXX X X X X X XXXXXXX X X XXX X X XXXXXXXXXXXXXXX XXX X XXX X X XXXXXXXXX X X
X X       X X   X X   X   X X X   X   X   X X X   X X X         X   X     X X     X X     X   X X X
X X XXXXXXX XXX X X XXXXX X X XXXXX XXX X XXX X XXX X X XXXXXXX X X X X XXX X XXXXX XXXXX X X X X X
X X X X     X   X X     X X         X   X     X X   X X       X X X   X     X X         X   X X X X
X X X X XXX X XXXXXXX X XXXXXXXXXXXXX XXXXXXXXX X X X X XXXXXXX X XXXXXXXXXXXXX XXX XXXXXXXXX X X X
X X X   X   X X     X X     X       X X     X   X X X X X     X X   X     X     X   X       X   X X
X X X XXX XXX XXX X XXX X X X XXXXX X X XXX X XXX XXX XXX XXX X XXX X X XXX X XXX XXX XXX X XXXXX X
X X X   X X X   X X   X X X X   X X   X X   X X X X   X   X     X   X X X   X X X   X X X X   X   X
X X XXXXX X XXX X XXX XXX X XXX X XXXXX XXXXX X X X XXX X XXXXXXX XXX X X XXX X XXX X X X XXXXX X X
X X       X   X   X   X   X   X X     X         X X X   X X       X   X X X   X     X X X       X X
X XXXXXXXXX X XXXXX XXX XXX XXX X X XXX XXXXXXXXX X X XXX X XXXXXXX XXX X X XXXXXXXXX X XXXXXXXXX X
X   X     X X     X X   X X X   X X       X     X     X   X X         X   X   X       X     X   X X
X X X XXX X XXX XXX XXX X X X XXX XXXXXXXXX XXX X XXXXXXX X XXXXXXXXXXXXXXXXX X XXXXXXX XXX X X X X
X X X   X           X   X   X X X   X X     X           X X     X     X       X               X X X
XXX XXX XX          X XXX XXX X XXX X X XXXXX           XXXXXXX X XXX X XXXXXXXX          XXXXXXX X
X     X               X X   X X       X                       X   X X X       X                 X X
X XXXXXXXX          X X XXX X X XXXXXXXXXXXXX          XXXX X XXXXX X X XXXXX X           XXXXX X X
X X                 X X X   X X     X   X               X X X X       X   X   X           X   X   X
X X XXXXXX          X X X XXX XXXXXXX X X XXX           X X X X XXXXXXXXX X XXXX          X XXXXX X
X X     X             X   X X   X     X   X               X X X X   X     X               X     X X
X XXXXX X           XXX XXX XXX X XXXXXXXXX X           XXX X X X X XXXXXXXXXXX           XXXXX X X
X     X X           X         X X     X     X           X   X X X X     X     X           X     X X
X XXX X X           X XXXXXXX X XXXXX X XXX X          XX XXXXX X XXXXX X XXX X           X XXXXX X
X X   X X X   X X       X   X X X     X X   X   X   X   X X   X X     X   X X X     X X   X X     X
XXX X X X X X X XXXXXXX X X XXX X XXXXX X XXXXX X X X XXX X X X X XXX XXXXX X XXXXX X XXXXX X XXXXX
X   X X X X X X       X X X     X X X   X     X   X X X   X X   X   X X     X   X X X X     X X   X
X XXXXX X X X XXXXXXX X X XXXXX X X X XXXXXXX XXXXX X X X X XXXXXXXXX X XXX XXX X X X X X XXX XXX X
X       X   X       X X X X   X X X X   X   X   X X X X X X X   X     X   X   X X   X X X X   X   X
X XXXXXXX XXXXXXXXXXX X X X X XXX X XXX X X XXX X X X X X X X X X XXXXXXX X XXX XXXXX X XXX XXX X X
X X   X   X   X       X X X X   X   X X X X X     X   X X X   X X   X   X X     X   X X   X     X X
X X X XXXXX X X XXXXXXX X X XXX XXX X X X X XXXXXXXXX X XXXXXXX XXX X X X XXXXXXX X X X X XXXXXXX X
X   X       X   X       X     X       X   X           X             X X           X   X X         X
XXXXXXXXXXXXXXXXXXXXXXXXXXXXXXXXXXXXXXXXXXXXXXXXXXXXXXXXXXXXXXXXXXXXXXXXXXXXXXXXXXXXXXXXXXXXXXXXXXX
